你 的 舌 頭 往 前 移 動 了 呢 - 好 棒 - 
你 的 舌 頭 好 有 活 力 唷 - 
你 的 舌 頭 真 靈 活 - 
你 的 舌 頭 會 跳 舞 耶 - 
你 的 舌 頭 像 美 麗 的 海 浪 一 樣 - 
你 的 舌 頭 會 跳 芭 雷 耶 -   好 酷 - 
你 的 喉 嚨 好 有 力 氣 呀 - 
你 的 喉 嚨 是 個 大 力 士 耶 - 
你 的 喉 嚨 像 噴 火 龍 一 樣 - 轟 轟 轟 -   好 帥 - 
你 的 喉 嚨 像 台 噴 射 機 - 轟 隆 隆 -   好 炫 - 
你 的 喉 嚨 像 位 大 猩 猩 - 好 有 力 氣 - 
你 的 喉 嚨 讓 聲 音 跑 出 來 了 - 好 優 秀 - 
哇 - 你 發 出 了 會 讓 牙 齒 涼 涼 的 聲 音   好 厲 害 - 
你 的 牙 齒 感 受 到 你 的 努 力 了 喔 - 它 涼 涼 的 好 舒 服 
哇 - 你 的 嘴 巴 打 開 就 像 電 風 扇 一 樣 讓 牙 齒 好 涼 快 - 
牙 齒 說 它 好 喜 歡 你 發 出 涼 涼 的 風 ～ 
有 一 陣 風 從 你 的 嘴 巴 跑 出 來 跟 牙 齒 說 哈 囉 耶 ! 
氣 流 從 嘴 巴 咝 咝 咝 的 跑 出 來 了 - 很 棒 喔 - 
你 的 舌 頭 會 幫 牙 齒 吹 風 耶 -   好 厲 害 - 
你 的 舌 頭 會 跟 牙 齒 合 作 - 真 棒 - 
你 的 舌 頭 會 跟 牙 齒 說 你 好 呀 - 
你 的 舌 頭 是 台 電 風 扇 - 讓 牙 齒 好 涼 快 - 
你 的 舌 頭 像 扇 子 一 樣 - 幫 牙 齒 搧 風 - 真 酷 - 
你 的 舌 頭 跟 像 風 車 一 樣 - 讓 牙 齒 好 舒 服 - 
你 的 嘴 巴 像 電 風 扇 一 樣 - 呼 呼 呼 - 
你 的 嘴 巴 跟 風 一 樣 - 咻 咻 咻 - 
你 的 嘴 巴 跟 戰 鬥 機 一 樣 厲 害 欸 - 
你 的 嘴 巴 就 像 秋 天 的 強 風 - 好 強 喔 - 
我 感 受 到 你 嘴 巴 發 出 風 的 力 量 了 ～ 很 棒 喔 
聽 說 你 的 嘴 巴 會 像 扇 子 發 出 有 力 量 的 風 - 讚 喔 - 
你 的 聲 音 像 兩 個 積 木 一 樣 拼 起 來 了 - 好 神 奇 呀 - 
你 的 聲 音 像 層 層 堆 疊 的 美 麗 雲 朵 - 好 棒 呀 - 
你 的 聲 音 像 丸 子 一 樣 串 在 一 起 了 - 很 努 力 唷 - 
你 的 聲 音 像 兩 塊 拼 圖 一 樣 - 組 合 在 一 起 了 呢 - 
你 的 聲 音 像 兩 顆 疊 在 一 起 的 雪 球 - 組 成 一 個 可 愛 的 雪 人 呢 - 
你 的 聲 音 像 兩 顆 融 化 的 冰 淇 淋 - 融 合 在 一 起 了 耶 - 
